744444444444444444444
722222222222222222222
7....................
7....................
71115................
74443....P...........
74443................
72226................
7....................
7....................
711111111111111111111
744444444444444444444
